OOOOOOOOO
O******FO
O**O*OO*O
O*O*****O
O***OO**O
O*O*O**OO
O*O**O**O
O*****O*O
OOOOOOOOO
