OOOOOOOOO
O*******O
O*O*O*O*O
O*O*O*O*O
O*O*OFO*O
OOOOOOOOO
